//MAP CONVERTED BY dmm2tgm.py THIS HEADER COMMENT PREVENTS RECONVERSION, DO NOT REMOVE
"a" = (
/turf/closed/indestructible/reinforced,
/area/ruin/space/has_grav/powered/superjail/bossroom)
"c" = (
/obj/machinery/light/floor,
/turf/open/floor/iron/smooth,
/area/ruin/space/has_grav/powered/superjail/bossroom)
"f" = (
/obj/structure/superjail_generator,
/turf/open/floor/circuit,
/area/ruin/space/has_grav/powered/superjail/bossroom)
"i" = (
/turf/open/floor/circuit/red/anim,
/area/ruin/space/has_grav/powered/superjail/bossroom)
"m" = (
/turf/closed/indestructible/syndicate,
/area/ruin/space/has_grav/powered/superjail/bossroom)
"n" = (
/turf/template_noop,
/area/template_noop)
"q" = (
/mob/living/basic/boss/super_jail,
/turf/open/floor/circuit/red/anim,
/area/ruin/space/has_grav/powered/superjail/bossroom)
"s" = (
/turf/open/floor/iron/smooth,
/area/ruin/space/has_grav/powered/superjail/bossroom)
"u" = (
/obj/effect/turf_decal/stripes/full,
/obj/structure/puzzle_blockade{
	id = "supermax"
	},
/turf/open/floor/iron/smooth,
/area/ruin/space/has_grav/powered/superjail/bossroom)
"K" = (
/obj/machinery/puzzle_keycardpad/directional/north{
	id = "supermax";
	queue_size = 4
	},
/obj/item/keycard{
	puzzle_id = "supermax"
	},
/turf/open/floor/iron/smooth,
/area/ruin/space/has_grav/powered/superjail/bossroom)
"O" = (
/turf/open/floor/circuit,
/area/ruin/space/has_grav/powered/superjail/bossroom)
"V" = (
/turf/open/floor/catwalk_floor/iron_smooth,
/area/ruin/space/has_grav/powered/superjail/bossroom)

(1,1,1) = {"
n
n
n
n
n
n
n
n
n
n
n
n
n
n
n
n
n
n
n
n
n
n
n
n
n
n
n
n
n
n
n
n
n
n
n
n
n
n
n
n
n
n
n
n
n
"}
(2,1,1) = {"
n
n
n
n
n
n
n
n
n
n
n
n
n
n
n
n
n
n
n
n
n
n
n
n
n
n
n
n
n
n
n
n
n
n
n
n
n
n
n
n
n
n
n
n
n
"}
(3,1,1) = {"
n
n
n
n
n
n
n
n
n
n
n
n
n
n
n
n
n
n
n
n
n
n
n
n
n
n
n
n
n
n
n
n
n
n
n
n
n
n
n
n
n
n
n
n
n
"}
(4,1,1) = {"
n
n
n
n
n
n
n
n
n
n
n
n
n
n
n
n
n
n
n
n
n
n
n
n
n
n
n
n
n
n
n
n
n
n
n
n
n
n
n
n
n
n
n
n
n
"}
(5,1,1) = {"
n
n
n
n
n
n
n
n
n
n
n
n
n
n
n
n
n
n
n
n
n
n
n
n
n
n
n
n
n
n
n
n
n
n
n
n
n
n
n
n
n
n
n
n
n
"}
(6,1,1) = {"
n
n
n
n
n
n
n
n
n
n
n
n
n
n
n
n
n
n
n
n
n
n
n
n
n
n
n
n
n
n
n
n
n
n
n
n
n
n
n
n
n
n
n
n
n
"}
(7,1,1) = {"
n
n
n
n
n
n
n
n
n
n
n
n
n
n
n
n
n
n
n
n
n
n
n
n
n
n
n
n
n
n
n
n
n
n
n
n
n
n
n
n
n
n
n
n
n
"}
(8,1,1) = {"
n
n
n
n
n
n
n
n
n
n
n
n
n
n
n
n
n
n
n
n
n
n
n
n
n
n
n
n
n
n
n
n
n
n
n
n
n
n
n
n
n
n
n
n
n
"}
(9,1,1) = {"
n
n
n
n
n
n
n
n
n
n
n
n
n
n
n
n
n
n
n
n
n
n
n
n
n
n
n
n
n
n
n
n
n
n
n
n
n
n
n
n
n
n
n
n
n
"}
(10,1,1) = {"
n
n
n
n
n
n
n
n
n
n
n
n
n
n
n
n
n
n
n
n
n
n
n
n
n
n
n
n
n
n
n
n
n
n
n
n
n
n
n
n
n
n
n
n
n
"}
(11,1,1) = {"
n
n
n
n
n
n
n
n
n
n
n
n
n
n
n
n
n
n
n
n
n
n
n
n
n
n
n
n
n
n
n
n
n
n
n
n
n
n
n
n
n
n
n
n
n
"}
(12,1,1) = {"
n
n
n
n
n
n
n
n
n
n
n
n
n
n
n
n
n
n
n
n
n
n
n
n
n
n
n
n
n
n
n
n
n
n
n
n
n
n
n
n
n
n
n
n
n
"}
(13,1,1) = {"
n
n
n
n
n
n
n
n
n
n
n
n
n
n
n
n
n
n
n
n
n
n
n
n
n
n
n
n
n
n
n
n
n
n
n
n
n
n
n
n
n
n
n
n
n
"}
(14,1,1) = {"
n
n
n
n
n
n
n
n
n
n
n
n
n
n
n
n
n
n
n
n
n
n
n
n
n
n
n
n
n
n
n
n
n
n
n
n
n
n
n
n
n
n
n
n
n
"}
(15,1,1) = {"
n
n
n
n
n
n
n
n
n
n
n
n
n
n
n
n
n
n
n
n
n
n
n
n
n
n
n
n
n
n
n
n
n
n
n
n
n
n
n
n
n
n
n
n
n
"}
(16,1,1) = {"
n
n
n
n
n
n
n
n
n
n
n
n
n
n
n
n
n
n
a
a
a
a
a
a
a
a
a
a
a
n
n
n
n
n
n
n
n
n
n
n
n
n
n
n
n
"}
(17,1,1) = {"
n
n
n
n
n
n
n
n
n
n
n
n
n
n
n
n
n
a
a
c
s
s
s
s
s
s
s
c
a
a
n
n
n
n
n
n
n
n
n
n
n
n
n
n
n
"}
(18,1,1) = {"
n
n
n
n
n
n
n
n
n
n
n
n
n
n
n
n
n
a
c
V
V
V
V
V
V
V
V
V
c
a
n
n
n
n
n
n
n
n
n
n
n
n
n
n
n
"}
(19,1,1) = {"
n
n
n
n
n
n
n
n
n
n
n
n
n
n
n
n
n
a
s
V
O
f
O
O
O
f
O
V
s
a
a
a
a
n
n
n
n
n
n
n
n
n
n
n
n
"}
(20,1,1) = {"
n
n
n
n
n
n
n
n
n
n
n
n
n
n
n
n
n
a
s
V
O
V
V
V
V
V
O
V
s
m
K
s
a
n
n
n
n
n
n
n
n
n
n
n
n
"}
(21,1,1) = {"
n
n
n
n
n
n
n
n
n
n
n
n
n
n
n
n
n
a
s
V
O
V
i
i
i
V
O
V
s
u
s
s
a
n
n
n
n
n
n
n
n
n
n
n
n
"}
(22,1,1) = {"
n
n
n
n
n
n
n
n
n
n
n
n
n
n
n
n
n
a
s
V
O
V
i
q
i
V
O
V
s
u
s
s
a
n
n
n
n
n
n
n
n
n
n
n
n
"}
(23,1,1) = {"
n
n
n
n
n
n
n
n
n
n
n
n
n
n
n
n
n
a
s
V
O
V
i
i
i
V
O
V
s
u
s
s
a
n
n
n
n
n
n
n
n
n
n
n
n
"}
(24,1,1) = {"
n
n
n
n
n
n
n
n
n
n
n
n
n
n
n
n
n
a
s
V
O
V
V
V
V
V
O
V
s
m
s
s
a
n
n
n
n
n
n
n
n
n
n
n
n
"}
(25,1,1) = {"
n
n
n
n
n
n
n
n
n
n
n
n
n
n
n
n
n
a
s
V
O
f
O
O
O
f
O
V
s
a
a
a
a
n
n
n
n
n
n
n
n
n
n
n
n
"}
(26,1,1) = {"
n
n
n
n
n
n
n
n
n
n
n
n
n
n
n
n
n
a
c
V
V
V
V
V
V
V
V
V
c
a
n
n
n
n
n
n
n
n
n
n
n
n
n
n
n
"}
(27,1,1) = {"
n
n
n
n
n
n
n
n
n
n
n
n
n
n
n
n
n
a
a
c
s
s
s
s
s
s
s
c
a
a
n
n
n
n
n
n
n
n
n
n
n
n
n
n
n
"}
(28,1,1) = {"
n
n
n
n
n
n
n
n
n
n
n
n
n
n
n
n
n
n
a
a
a
a
a
a
a
a
a
a
a
n
n
n
n
n
n
n
n
n
n
n
n
n
n
n
n
"}
(29,1,1) = {"
n
n
n
n
n
n
n
n
n
n
n
n
n
n
n
n
n
n
n
n
n
n
n
n
n
n
n
n
n
n
n
n
n
n
n
n
n
n
n
n
n
n
n
n
n
"}
(30,1,1) = {"
n
n
n
n
n
n
n
n
n
n
n
n
n
n
n
n
n
n
n
n
n
n
n
n
n
n
n
n
n
n
n
n
n
n
n
n
n
n
n
n
n
n
n
n
n
"}
(31,1,1) = {"
n
n
n
n
n
n
n
n
n
n
n
n
n
n
n
n
n
n
n
n
n
n
n
n
n
n
n
n
n
n
n
n
n
n
n
n
n
n
n
n
n
n
n
n
n
"}
(32,1,1) = {"
n
n
n
n
n
n
n
n
n
n
n
n
n
n
n
n
n
n
n
n
n
n
n
n
n
n
n
n
n
n
n
n
n
n
n
n
n
n
n
n
n
n
n
n
n
"}
(33,1,1) = {"
n
n
n
n
n
n
n
n
n
n
n
n
n
n
n
n
n
n
n
n
n
n
n
n
n
n
n
n
n
n
n
n
n
n
n
n
n
n
n
n
n
n
n
n
n
"}
(34,1,1) = {"
n
n
n
n
n
n
n
n
n
n
n
n
n
n
n
n
n
n
n
n
n
n
n
n
n
n
n
n
n
n
n
n
n
n
n
n
n
n
n
n
n
n
n
n
n
"}
(35,1,1) = {"
n
n
n
n
n
n
n
n
n
n
n
n
n
n
n
n
n
n
n
n
n
n
n
n
n
n
n
n
n
n
n
n
n
n
n
n
n
n
n
n
n
n
n
n
n
"}
(36,1,1) = {"
n
n
n
n
n
n
n
n
n
n
n
n
n
n
n
n
n
n
n
n
n
n
n
n
n
n
n
n
n
n
n
n
n
n
n
n
n
n
n
n
n
n
n
n
n
"}
(37,1,1) = {"
n
n
n
n
n
n
n
n
n
n
n
n
n
n
n
n
n
n
n
n
n
n
n
n
n
n
n
n
n
n
n
n
n
n
n
n
n
n
n
n
n
n
n
n
n
"}
(38,1,1) = {"
n
n
n
n
n
n
n
n
n
n
n
n
n
n
n
n
n
n
n
n
n
n
n
n
n
n
n
n
n
n
n
n
n
n
n
n
n
n
n
n
n
n
n
n
n
"}
(39,1,1) = {"
n
n
n
n
n
n
n
n
n
n
n
n
n
n
n
n
n
n
n
n
n
n
n
n
n
n
n
n
n
n
n
n
n
n
n
n
n
n
n
n
n
n
n
n
n
"}
(40,1,1) = {"
n
n
n
n
n
n
n
n
n
n
n
n
n
n
n
n
n
n
n
n
n
n
n
n
n
n
n
n
n
n
n
n
n
n
n
n
n
n
n
n
n
n
n
n
n
"}
(41,1,1) = {"
n
n
n
n
n
n
n
n
n
n
n
n
n
n
n
n
n
n
n
n
n
n
n
n
n
n
n
n
n
n
n
n
n
n
n
n
n
n
n
n
n
n
n
n
n
"}
(42,1,1) = {"
n
n
n
n
n
n
n
n
n
n
n
n
n
n
n
n
n
n
n
n
n
n
n
n
n
n
n
n
n
n
n
n
n
n
n
n
n
n
n
n
n
n
n
n
n
"}
(43,1,1) = {"
n
n
n
n
n
n
n
n
n
n
n
n
n
n
n
n
n
n
n
n
n
n
n
n
n
n
n
n
n
n
n
n
n
n
n
n
n
n
n
n
n
n
n
n
n
"}
(44,1,1) = {"
n
n
n
n
n
n
n
n
n
n
n
n
n
n
n
n
n
n
n
n
n
n
n
n
n
n
n
n
n
n
n
n
n
n
n
n
n
n
n
n
n
n
n
n
n
"}
(45,1,1) = {"
n
n
n
n
n
n
n
n
n
n
n
n
n
n
n
n
n
n
n
n
n
n
n
n
n
n
n
n
n
n
n
n
n
n
n
n
n
n
n
n
n
n
n
n
n
"}
