//MAP CONVERTED BY dmm2tgm.py THIS HEADER COMMENT PREVENTS RECONVERSION, DO NOT REMOVE
"a" = (
/turf/closed/indestructible,
/area/misc/testroom)
"f" = (
/obj/structure/superjail_generator,
/turf/open/floor/circuit,
/area/misc/testroom)
"n" = (
/turf/template_noop,
/area/template_noop)
"q" = (
/mob/living/basic/boss/super_jail,
/turf/open/floor/circuit,
/area/misc/testroom)
"O" = (
/turf/open/floor/circuit,
/area/misc/testroom)

(1,1,1) = {"
n
n
n
n
n
n
n
n
n
n
n
n
n
n
n
"}
(2,1,1) = {"
n
n
a
a
a
a
a
a
a
a
a
a
a
n
n
"}
(3,1,1) = {"
n
a
a
O
O
O
O
O
O
O
O
O
a
a
n
"}
(4,1,1) = {"
n
a
O
O
O
O
O
O
O
O
O
O
O
a
n
"}
(5,1,1) = {"
n
a
O
O
O
f
O
O
O
f
O
O
O
a
n
"}
(6,1,1) = {"
n
a
O
O
O
O
O
O
O
O
O
O
O
a
n
"}
(7,1,1) = {"
n
a
O
O
O
O
O
O
O
O
O
O
O
a
n
"}
(8,1,1) = {"
n
a
O
O
O
O
O
q
O
O
O
O
O
a
n
"}
(9,1,1) = {"
n
a
O
O
O
O
O
O
O
O
O
O
O
a
n
"}
(10,1,1) = {"
n
a
O
O
O
O
O
O
O
O
O
O
O
a
n
"}
(11,1,1) = {"
n
a
O
O
O
f
O
O
O
f
O
O
O
a
n
"}
(12,1,1) = {"
n
a
O
O
O
O
O
O
O
O
O
O
O
a
n
"}
(13,1,1) = {"
n
a
a
O
O
O
O
O
O
O
O
O
a
a
n
"}
(14,1,1) = {"
n
n
a
a
a
a
a
a
a
a
a
a
a
n
n
"}
(15,1,1) = {"
n
n
n
n
n
n
n
n
n
n
n
n
n
n
n
"}
