//MAP CONVERTED BY dmm2tgm.py THIS HEADER COMMENT PREVENTS RECONVERSION, DO NOT REMOVE
"a" = (
/turf/closed/indestructible/reinforced,
/area/ruin/space/has_grav/powered/superjail/bossroom)
"c" = (
/obj/machinery/light/floor,
/turf/open/floor/iron/smooth,
/area/ruin/space/has_grav/powered/superjail/bossroom)
"f" = (
/obj/structure/superjail_generator,
/turf/open/floor/circuit,
/area/ruin/space/has_grav/powered/superjail/bossroom)
"i" = (
/turf/open/floor/circuit/red/anim,
/area/ruin/space/has_grav/powered/superjail/bossroom)
"n" = (
/turf/template_noop,
/area/template_noop)
"q" = (
/mob/living/basic/boss/super_jail,
/turf/open/floor/circuit/red/anim,
/area/ruin/space/has_grav/powered/superjail/bossroom)
"s" = (
/turf/open/floor/iron/smooth,
/area/ruin/space/has_grav/powered/superjail/bossroom)
"O" = (
/turf/open/floor/circuit,
/area/ruin/space/has_grav/powered/superjail/bossroom)
"V" = (
/turf/open/floor/catwalk_floor/iron_smooth,
/area/ruin/space/has_grav/powered/superjail/bossroom)

(1,1,1) = {"
n
n
n
n
n
n
n
n
n
n
n
n
n
n
n
"}
(2,1,1) = {"
n
n
a
a
a
a
a
a
a
a
a
a
a
n
n
"}
(3,1,1) = {"
n
a
a
c
s
s
s
s
s
s
s
c
a
a
n
"}
(4,1,1) = {"
n
a
c
V
V
V
V
V
V
V
V
V
c
a
n
"}
(5,1,1) = {"
n
a
s
V
O
f
O
O
O
f
O
V
s
a
n
"}
(6,1,1) = {"
n
a
s
V
O
V
V
V
V
V
O
V
s
a
n
"}
(7,1,1) = {"
n
a
s
V
O
V
i
i
i
V
O
V
s
a
n
"}
(8,1,1) = {"
n
a
s
V
O
V
i
q
i
V
O
V
s
a
n
"}
(9,1,1) = {"
n
a
s
V
O
V
i
i
i
V
O
V
s
a
n
"}
(10,1,1) = {"
n
a
s
V
O
V
V
V
V
V
O
V
s
a
n
"}
(11,1,1) = {"
n
a
s
V
O
f
O
O
O
f
O
V
s
a
n
"}
(12,1,1) = {"
n
a
c
V
V
V
V
V
V
V
V
V
c
a
n
"}
(13,1,1) = {"
n
a
a
c
s
s
s
s
s
s
s
c
a
a
n
"}
(14,1,1) = {"
n
n
a
a
a
a
a
a
a
a
a
a
a
n
n
"}
(15,1,1) = {"
n
n
n
n
n
n
n
n
n
n
n
n
n
n
n
"}
