//MAP CONVERTED BY dmm2tgm.py THIS HEADER COMMENT PREVENTS RECONVERSION, DO NOT REMOVE
"b" = (
/turf/closed/wall/mineral/titanium,
/area/shuttle/arrival)
"c" = (
/obj/machinery/door/airlock/titanium{
	name = "Arrivals Shuttle Airlock"
	},
/turf/open/floor/plating,
/area/shuttle/arrival)
"d" = (
/obj/effect/spawner/structure/window/reinforced/shuttle,
/turf/open/floor/plating,
/area/shuttle/arrival)
"e" = (
/obj/structure/table,
/obj/item/storage/medkit/regular,
/turf/open/floor/mineral/titanium/blue,
/area/shuttle/arrival)
"f" = (
/turf/open/floor/mineral/titanium/blue,
/area/shuttle/arrival)
"g" = (
/obj/effect/spawner/random/entertainment/arcade,
/obj/machinery/light/directional/north,
/turf/open/floor/mineral/titanium/blue,
/area/shuttle/arrival)
"h" = (
/obj/structure/closet/wardrobe/green,
/turf/open/floor/mineral/titanium/blue,
/area/shuttle/arrival)
"r" = (
/obj/machinery/power/shuttle_engine/propulsion{
	dir = 4
	},
/turf/open/floor/plating,
/area/shuttle/arrival)
"s" = (
/turf/closed/wall/mineral/plastitanium/nodiagonal,
/area/shuttle/arrival)
"t" = (
/obj/machinery/power/shuttle_engine/heater{
	dir = 4
	},
/obj/structure/window/reinforced{
	dir = 8
	},
/turf/open/floor/plating,
/area/shuttle/arrival)
"v" = (
/obj/structure/chair/comfy/shuttle{
	dir = 1
	},
/turf/open/floor/mineral/titanium/blue,
/area/shuttle/arrival)
"x" = (
/obj/structure/closet/emcloset,
/turf/open/floor/mineral/titanium/blue,
/area/shuttle/arrival)
"y" = (
/obj/machinery/power/shuttle_engine/propulsion{
	dir = 4
	},
/obj/docking_port/mobile/arrivals,
/turf/open/floor/plating,
/area/shuttle/arrival)
"S" = (
/turf/open/floor/mineral/titanium,
/area/shuttle/arrival)
"U" = (
/obj/item/radio/intercom/directional/south,
/obj/structure/chair/comfy/shuttle{
	dir = 1
	},
/turf/open/floor/mineral/titanium/blue,
/area/shuttle/arrival)

(1,1,1) = {"
b
d
d
d
b
"}
(2,1,1) = {"
b
e
f
x
b
"}
(3,1,1) = {"
d
f
S
v
b
"}
(4,1,1) = {"
c
f
S
v
b
"}
(5,1,1) = {"
d
f
S
v
b
"}
(6,1,1) = {"
b
g
S
v
b
"}
(7,1,1) = {"
c
f
S
U
b
"}
(8,1,1) = {"
b
h
h
h
b
"}
(9,1,1) = {"
s
t
t
t
s
"}
(10,1,1) = {"
s
r
y
r
s
"}
